05 00 00 00 00 00 00 00 00 00 00 00 00 00 00 00 00 00 00 00 00 00 00 00 00 00 00 00 00 00 00 00 00 00 00 00 00 00 00 00 00 00 00 00 00 00 00 00 00 00 00 00 00 00 00 00 00 00 00 00 00 00 00 00 00 00 00 00 00 00 00 05
05 00 00 00 00 00 00 00 00 00 00 00 00 00 00 00 00 00 00 00 00 00 00 00 00 00 00 00 00 00 00 00 00 00 00 00 00 00 00 00 00 00 00 00 00 00 00 00 00 00 00 00 00 00 00 00 00 00 00 00 00 00 00 00 00 00 00 00 00 00 00 05
05 00 00 00 00 00 00 00 00 00 00 00 00 00 00 00 00 00 00 17 18 19 00 00 00 00 00 00 00 00 00 00 00 00 00 00 00 17 18 18 19 00 00 00 00 00 00 00 00 00 00 00 00 00 00 00 00 00 00 00 00 00 00 00 00 00 00 00 00 00 00 05
05 00 00 00 00 00 00 00 00 00 00 00 00 00 00 00 00 00 00 20 21 22 00 00 00 00 00 17 18 18 18 19 00 00 00 00 00 20 21 21 22 00 00 00 00 00 00 00 00 00 17 18 18 19 00 00 00 00 00 00 00 00 00 00 00 00 00 00 00 00 00 05
05 00 00 00 00 00 00 00 00 00 00 00 00 00 00 00 00 00 00 00 00 00 00 00 00 00 00 20 21 21 21 22 00 00 00 00 00 00 00 00 00 00 00 00 00 00 00 00 00 00 20 21 21 22 00 00 00 00 00 00 00 00 00 00 00 00 00 00 00 00 00 05
05 00 00 00 00 00 00 00 00 00 00 00 00 00 00 00 00 00 00 00 00 00 00 00 00 00 00 00 00 00 00 00 00 00 00 00 00 00 00 00 00 00 00 00 00 00 00 00 00 00 00 00 00 00 00 00 00 00 00 00 00 00 00 00 00 00 00 00 00 00 00 05
05 00 00 00 00 00 00 00 00 00 00 00 00 00 00 00 00 00 00 00 00 00 07 00 00 00 00 00 00 00 00 00 00 00 00 00 00 00 00 00 00 00 00 00 00 00 00 00 00 00 00 00 00 00 00 00 00 00 00 00 00 00 00 00 00 00 00 00 00 00 00 05
05 00 00 00 00 00 00 00 00 00 00 00 00 00 00 00 00 00 00 00 00 00 00 00 00 00 00 00 00 00 00 00 00 00 00 00 00 00 00 00 00 00 00 00 00 00 00 00 00 00 00 02 00 00 00 00 00 00 00 00 00 00 00 00 00 00 00 00 00 00 00 05
05 00 00 00 00 00 00 00 00 00 00 00 00 00 00 00 00 00 00 00 00 00 00 00 00 00 00 00 00 00 00 00 00 00 00 00 00 00 00 00 00 00 00 00 00 00 00 00 00 00 00 00 00 00 00 00 00 00 00 00 00 00 00 00 00 00 00 00 00 00 00 05
05 00 00 00 00 00 00 00 00 00 00 00 00 00 00 00 00 00 00 00 00 00 00 00 00 00 00 00 00 00 00 00 00 00 00 00 00 00 00 00 00 00 00 00 00 00 00 00 00 00 00 00 00 00 00 00 00 00 00 14 15 00 00 00 00 00 00 00 05 05 05 05
05 00 00 00 00 00 00 00 00 00 00 00 00 00 00 00 07 00 00 00 02 07 02 07 02 00 00 00 00 00 00 00 00 02 02 00 00 00 00 00 00 00 00 02 00 00 14 15 00 00 00 00 00 00 00 00 00 00 00 13 16 00 00 00 00 00 00 05 05 05 05 05
05 00 00 00 24 00 00 00 00 00 00 00 00 00 00 00 00 00 00 00 00 00 00 00 00 00 00 00 00 00 00 00 00 00 00 00 00 00 14 15 00 00 00 00 00 00 13 16 00 00 00 00 00 00 00 24 00 00 00 13 16 00 00 00 00 05 05 05 05 05 05 05
05 00 00 23 26 25 00 00 00 00 00 00 00 00 00 00 00 24 00 00 00 00 00 00 00 00 00 00 14 15 00 00 00 00 00 00 00 00 13 16 00 00 00 00 00 00 13 16 00 00 00 00 00 00 23 26 25 00 00 13 16 00 00 00 05 05 05 05 05 05 05 05
05 00 23 26 27 26 25 00 00 00 00 08 09 10 11 12 23 26 25 00 00 00 00 08 09 12 00 00 13 16 00 00 00 00 00 00 00 00 13 16 00 08 09 11 12 00 13 16 00 08 09 11 12 23 26 27 26 25 00 13 16 00 00 05 05 05 05 05 05 05 05 05
03 03 03 03 03 03 03 03 03 03 03 03 03 03 03 03 03 03 03 03 03 03 03 03 03 03 03 03 03 03 03 03 03 03 03 03 03 03 03 03 03 03 03 03 03 03 03 03 03 03 03 03 03 03 03 03 03 03 03 03 03 03 03 03 03 03 03 03 03 03 03 03 
03 03 03 03 03 03 03 03 03 03 03 03 03 03 03 03 03 03 03 03 03 03 03 03 03 03 03 03 03 03 03 03 03 03 03 03 03 03 03 03 03 03 03 03 03 03 03 03 03 03 03 03 03 03 03 03 03 03 03 03 03 03 03 03 03 03 03 03 03 03 03 03 